XXXXXXXXXXXXXXXXXXXXXXXXXXXXXXXXXXXXXXXXXXXXXXXXXXXXXXXXXXXXXXXXXXXXXXXXXXXXXXXXXXXXXXXXXXXXXXX                        
                                                                                              X                        
                                                                                              X                        
                                                                                              XXXXXXXXXXXXXXXXXXXXXXXXX
                                                                                              X                        
                                                                                              X                        
                                            XXXXXXXXXXXXXXXXXXXXXXXXXXXXXXXXXXXXXXXXXXXXXXXXXXX                        
                                            X                          X                                               
                                            X                          X                                               
                                            X                          X                                               
                                            X                          X                                               
            XXXXXXXXXXXXXXXXXXXXXXXXXXXXXXXXX                          X                                               
            X                                                          X                                               
            X                                                          X                                               
            X                                                          X                 XXXXXXXXXXXXXXXXXXXXX         
            X                                                          X                 X                             
            X                                                          X                 X                             
            XXXXXXXXXXXXXXXXXXXXXXXXXXXXXXXXXXXXXXXXXXXXXXXXXXXXXXXXXXXX                 X                             
                                         X                                               X                             
                                         X                                               X                             
                                         X                                               X                             
                                         X                                               XXXXXXXXXXXXXXXXXXXX          
                                         X                                                                  X          
                                         X                                                                  X          
  XXXXXXXXXXXXXXXXXXXXXXXXXXXXXXXXXXXXXXXX                                                                  X          
                                         X                                                                  X          
                                         X                                                                  XXXXXXXXXXX
                                         X                                                                  X          
                                         XXXXXXXXXXXXXXXXXXXXXXXXXXXXXXXXXXXXXXXXXX                         X          
                                                                                  X                         X          
                                                                                  X                         X          
                                                                                  X                         X          
                                                                                  X                         X          
                                                                                  XXXXXXXXXXXXXXXXXXXXXXXXXXX          
                                                                                                X                      
                                                                                                X                      
                                                                                                X                      
                                                                                                X                      
                                                                                                X                      
                                                                                                X                      